13 31 8
###############################
#p     ** *    *   *  * * *   #
# * # #*# # #*#*P # # #*#*#*# #
#   * 1   ***  *      *   * * #
# # # # # #*# # #*#*# # # # #*#
# s        x **  *  *         #
#2# # # # # # # # #*# #*# # # #
#*  *      *  *               #
# # # # #*# # # #*#*# # # # # #
#*    **  *       *           #
# #*# # w # # # #w# # # # # # #
#           *   *  *          #
###############################